SO ./path_south
NO ./path_north
WE ./path_west
EA ./path_east


C 1,2,3
F 220,100,0                       

        1111111111111111111111111    1111111111111
        1000000000110000000111111    1111000001011
        1011000001110000000000001    1111000000011
        1001000000300000000000001    1100001100011
111111111011000001110000000000001    1111001111111
100000000003000001110111111111111       1001
11111111111111111111111111111111111111111001111111
11100000000000000000000000000000000000000001101111
10000000000000000000000000000000000000000001111111
11111111111111111111111111113111111111111111111111
                           101
                           101
                           101
                           101
                           101
                           101
                           101
                           101
                           101
11111111111111111111111111113111111111111111111111
10000000000001100000000000000000000000000001111111
1000000000111  11110000000000000000000000000001111
1111011111       110000010001111111111111111111
111131111         11111011101010010001
1100000011        10101011100010010001
110000000011     1110000000300000010001
1000000000001   1000011010100100011111
11000001110101 1011111011110N0111
11110111 111011101011110100011
11111111 11111111111111111111