SO ./path_south
NO ./path_north
WE ./path_west
EA ./path_east

F 220,100,0
C 225,30,0

        1111111111111111111111111
        1000000000110000000000001
        1011000001110000000000001
        1001000000300000000000001
111111111011000001110000000000001
100000000003000001110111111111111
1111111111111111111111111111111111111111111111111

111111111111111111111111111111111
11110111111111011100000010001
11113111111111011101010010001
11000000110101011100010010001
10000000000000000300000010001
10000000000000001101010010001
11000001110101011111011110N01
11110111 1110101 101111010001
11111111 1111111 111111111111