SO textures/south3.xpm
NO textures/north3.xpm
WE textures/east3.xpm
EA textures/west3.xpm

C 111,139,210
F 220,200,10

1111111111111111111                    111111111111111111111111111111111111111111111111111111111111
1000000000000000011                    1000000000000000000000000000000000001     100000000000000001
1000000000000000011                    1000000000000000000000000000000000001     100000000S00000001
1000111113111110011                    1000000000000000000000000000000000001     100000000000000001
1000100000000010011                    100000000011111111111111111110000000111111113111111111111311
1000100000000010011                    10000000001                 1000000010000000001         1011
1000100000000010011                    10000000001111111111111111111000000010000000001         1011
1000100000000010011                    10000000000000000000000000000000000010000000001         1011
100011111311111001111111111111111111111100000000000000000000000000000000000100000000011111111111011
100000000000000000000000000000000000000000000000000000000000000010000000000000000000000000000001011
100000000000000000000000000000000000000000000000000000000000000011111111111111111111110000000003011
11111111111111111111111111111113111111111311111111111111111111111                    10000000001011
10000000100100000000000110000000000000000000000000000000000000001                    10000000001011
100010001001000000000001111113111111111113111111111111111113111111111111111111111111111113111111011
100010001000000000000000000000000000000000000000000000000000000000000000000000000000000000000000001
100010001001000000000000000000000011111111111000000000000111111111111111111111111100000000000000001
100010000001000000000000000000000000000000000011111111100000000000000000000000000000000000000000001
100010001001000000000000000000000000000000000000000000000000000000000000000000000000000000000000001
100010001001000111110001111131111111111111111111111113111111111111111311111111111111111111131111101
1000300000010001   10003010000001                 1000001111111111111000000000300000000000000000101
1000100011010001   10001010000001                 1000001           1000000000100000000111000000101
1000100000000001   10001010000001                 1000001           1000000000100110000111000000101
1000300010110001   10001030000001                 1000001           1000000000100110000000000000101
1000100010110001   10001010000001                 1000001111111111111000000000100000000000000000101
1000100010110001   10001010000001111111111111111111000001111111111113000000000300000000000000000101
1000100010110001   10001010000001111111111111111111113111111111111111111111111111111111111111111101
10000000101100011111000101000000000000000000000000000000000000001                               101
10000000100000000000000101113111111111111113111111111111131111111                               101
10000000101100000000000100000000000000000000000000000000000000001                               101
10000000111111111111111101111111111111111311111111111111111311111                               101
100000000000000000000000000000000000000000000000000000000000000011111111111111111111111111111111101
100000000000000000000000000000000000000000000000000000000000000000000000000000000000000000000000001
111111111111111111111111111111111111111111111111111111111111111111111111111111111111111111111111111
